n,municipio1,uf1,municipio2,uf2,pass_ida,pass_volta,pass_total,passxkm,sheet
1,ANAPOLIS,GO,CAMPINAS,SP,2737,2882,5619,5008504,4110
2,ANAPOLIS,GO,CUIABA,MT,1514,1633,3147,3170961,4110
3,ANAPOLIS,GO,PALMAS,TO,755,640,1395,1136786,4110
4,ANAPOLIS,GO,PORTO VELHO,RO,191,316,507,1256093,4110
5,ANAPOLIS,GO,UBERABA,MG,1031,960,1991,1023772,4110
6,ANAPOLIS,GO,UBERLANDIA,MG,1043,1583,2626,1065893,4110
7,ANAPOLIS,GO,VITORIA DA CONQUISTA,BA,51,75,126,150444,4110
8,ARACAJU,SE,ANAPOLIS,GO,65,111,176,326621,4110
9,ARACAJU,SE,CAMPINA GRANDE,PB,3136,3083,6219,3533411,4110
10,ARACAJU,SE,CARUARU,PE,6001,5940,11941,5055703,4110
11,ARACAJU,SE,FOZ DO IGUACU,PR,145,119,264,890866,4110
12,ARACAJU,SE,GOIANIA,GO,597,928,1525,2899788,4110
13,ARACAJU,SE,ITABUNA,BA,10410,11452,21862,15323392,4110
14,ARACAJU,SE,JOAO PESSOA,PB,7241,6609,13850,8393100,4110
15,ARACAJU,SE,JUAZEIRO DO NORTE,CE,814,769,1583,1100818,4110
16,ARACAJU,SE,MACEIO,AL,23283,21700,44983,12724471,4110
17,ARACAJU,SE,NATAL,RN,3597,3460,7057,6053907,4110
18,ARACAJU,SE,PALMAS,TO,174,143,317,523779,4110
19,ARACATUBA,SP,ARAGUARI,MG,138,128,266,143454,4110
20,ARACATUBA,SP,CAMPO GRANDE,MS,3444,3327,6771,3183807,4110
21,ARACATUBA,SP,GOIANIA,GO,1053,962,2015,1413367,4110
22,ARACATUBA,SP,LONDRINA,PR,3003,3711,6714,2840022,4110
23,ARACATUBA,SP,MARINGA,PR,3177,3679,6856,2713605,4110
24,ARACATUBA,SP,PRES PRUDENTE,SP,6247,6021,12268,2561558,4110
25,ARACATUBA,SP,UBERLANDIA,MG,850,759,1609,762125,4110
26,ARAGUARI,MG,CAMPINAS,SP,4129,3630,7759,4266674,4110
27,BARBACENA,MG,ANAPOLIS,GO,13,25,38,39159,4110
28,BARBACENA,MG,BARRA MANSA,RJ,2293,3172,5465,1585943,4110
29,BARBACENA,MG,BRAGANCA PAULISTA,SP,1022,1198,2220,1052724,4110
30,BARBACENA,MG,CABO FRIO,RJ,1875,2114,3989,1610359,4110
31,BARBACENA,MG,CACHOEIRO DO ITAPEMIRIM,ES,294,360,654,283051,4110
32,BARBACENA,MG,CAMPINAS,SP,4335,6059,10394,6238820,4110
33,BARBACENA,MG,NITEROI,RJ,829,481,1310,372171,4110
34,BARBACENA,MG,PALMAS,TO,46,51,97,166539,4110
35,BARBACENA,MG,RESENDE,RJ,413,243,656,212085,4110
36,BARBACENA,MG,SAO JOSE DOS CAMPOS,SP,2422,2136,4558,2288829,4110
37,BARBACENA,MG,VITORIA,ES,1101,1147,2248,1295298,4110
38,BARRA MANSA,RJ,GOV VALADARES,MG,787,500,1287,795237,4110
39,BARRA MANSA,RJ,JUIZ DE FORA,MG,33663,28204,61867,13010630,4110
40,BARRA MANSA,RJ,POUSO ALEGRE,MG,832,712,1544,421512,4110
41,BARRA MANSA,RJ,SAO JOSE DOS CAMPOS,SP,4771,2785,7556,1652497,4110
42,BARRA MANSA,RJ,TEOFILO OTONI,MG,208,301,509,384110,4110
43,BARRA MANSA,RJ,VARGINHA,MG,4572,3907,8479,2550544,4110
44,BARRETOS,SP,ARACAJU,SE,41,61,102,225787,4110
45,BARRETOS,SP,CAMPO GRANDE,MS,947,1160,2107,1655499,4110
46,BARRETOS,SP,CUIABA,MT,178,142,320,388416,4110
47,BARRETOS,SP,GOV VALADARES,MG,18,5,23,22657,4110
48,BARRETOS,SP,MACEIO,AL,106,140,246,610301,4110
49,BARRETOS,SP,PALMAS,TO,427,180,607,827523,4110
50,BARRETOS,SP,PORTO VELHO,RO,53,19,72,193212,4110
51,BARRETOS,SP,RIO BRANCO,AC,35,15,50,158710,4110
52,BARRETOS,SP,TEOFILO OTONI,MG,17,3,20,22372,4110
53,BARRETOS,SP,VITORIA DA CONQUISTA,BA,28,17,45,67671,4110
54,BLUMENAU,SC,CAMPO GRANDE,MS,297,524,821,1178710,4110
55,BLUMENAU,SC,CASCAVEL,PR,3669,3574,7243,5569437,4110
56,BLUMENAU,SC,FOZ DO IGUACU,PR,3281,3448,6729,5839011,4110
57,BRAGANCA PAULISTA,SP,JUIZ DE FORA,MG,327,450,777,367210,4110
58,CACHOEIRO DO ITAPEMIRIM,ES,ITABUNA,BA,404,483,887,772488,4110
59,CACHOEIRO DO ITAPEMIRIM,ES,NITEROI,RJ,2579,2252,4831,1892195,4110
60,CACHOEIRO DO ITAPEMIRIM,ES,SAO JOSE DOS CAMPOS,SP,245,271,516,363505,4110
61,CACHOEIRO DO ITAPEMIRIM,ES,TEIXEIRA DE FREITAS,BA,26,13,39,19874,4110
62,CACHOEIRO DO ITAPEMIRIM,ES,VOLTA REDONDA,RJ,613,855,1468,724311,4110
63,CAMPINA GRANDE,PB,CARUARU,PE,12390,12714,25104,3732965,4110
64,CAMPINA GRANDE,PB,ITABUNA,BA,189,21,210,253176,4110
65,CAMPINA GRANDE,PB,PETROLINA,PE,2887,2846,5733,4491232,4110
66,CAMPINA GRANDE,PB,SAO JOSE DOS CAMPOS,SP,428,754,1182,3099795,4110
67,CAMPINA GRANDE,PB,VOLTA REDONDA,RJ,104,127,231,554954,4110
68,CAMPINAS,SP,BARRA MANSA,RJ,213,188,401,161683,4110
69,CAMPINAS,SP,FLORIANOPOLIS,SC,1815,2101,3916,3254196,4110
70,CAMPINAS,SP,ITAJAI,SC,1221,1139,2360,1756076,4110
71,CAMPINAS,SP,JOINVILLE,SC,4421,4536,8957,5785326,4110
72,CAMPINAS,SP,JUIZ DE FORA,MG,711,955,1666,922298,4110
73,CAMPINAS,SP,MOGI-GUACU,SP,38873,47715,86588,5879325,4110
74,CAMPINAS,SP,PALMAS,TO,695,451,1146,1941095,4110
75,CAMPINAS,SP,PONTA GROSSA,PR,6873,8033,14906,7819688,4110
76,CAMPINAS,SP,PORTO VELHO,RO,141,88,229,693532,4110
77,CAMPINAS,SP,RESENDE,RJ,508,710,1218,448102,4110
78,CAMPINAS,SP,RIO BRANCO,AC,171,40,211,739492,4110
79,CAMPINAS,SP,VITORIA DA CONQUISTA,BA,3213,2332,5545,8499376,4110
80,CAMPO GRANDE,MS,ARAGUARI,MG,214,253,467,506230,4110
81,CAMPO GRANDE,MS,BARRA MANSA,RJ,1080,1014,2094,2813708,4110
82,CAMPO GRANDE,MS,CAMPINAS,SP,14749,14766,29515,31073392,4110
83,CAMPO GRANDE,MS,CUIABA,MT,36919,36592,73511,52281023,4110
84,CAMPO GRANDE,MS,GOIANIA,GO,14893,12778,27671,26833664,4110
85,CAMPO GRANDE,MS,JUIZ DE FORA,MG,90,101,191,311044,4110
86,CAMPO GRANDE,MS,LONDRINA,PR,1497,1013,2510,1745956,4110
87,CAMPO GRANDE,MS,PALMAS,TO,1133,1141,2274,4063183,4110
88,CAMPO GRANDE,MS,PORTO VELHO,RO,1091,661,1752,3820937,4110
89,CAMPO GRANDE,MS,RIO BRANCO,AC,191,460,651,1739212,4110
90,CAMPO GRANDE,MS,RONDONOPOLIS,MT,15743,16834,32577,16255923,4110
91,CAMPO GRANDE,MS,SAO JOSE DO RIO PRETO,SP,6755,6513,13268,9624316,4110
92,CAMPO GRANDE,MS,SAO JOSE DOS CAMPOS,SP,8906,8860,17766,20070113,4110
93,CAMPO GRANDE,MS,UBERLANDIA,MG,2855,2589,5444,5595921,4110
94,CARUARU,PE,JOAO PESSOA,PB,186,188,374,91443,4110
95,CARUARU,PE,JUAZEIRO,BA,4091,4163,8254,5271004,4110
96,CARUARU,PE,JUAZEIRO DO NORTE,CE,6328,5939,12267,6641354,4110
97,CARUARU,PE,MACEIO,AL,11573,11521,23094,4376313,4110
98,CARUARU,PE,NATAL,RN,2080,3097,5177,2201260,4110
99,CARUARU,PE,SAO LUIS,MA,3278,3294,6572,9353928,4110
100,CARUARU,PE,TERESINA,PI,574,583,1157,1153992,4110
101,CASCAVEL,PR,BARRA MANSA,RJ,141,177,318,389362,4110
102,CASCAVEL,PR,CAMPINAS,SP,3770,4018,7788,7076956,4110
103,CASCAVEL,PR,CAMPO GRANDE,MS,11544,13726,25270,19583359,4110
104,CASCAVEL,PR,CUIABA,MT,7170,8055,15225,23026341,4110
105,CASCAVEL,PR,JUIZ DE FORA,MG,117,99,216,304279,4110
106,CASCAVEL,PR,PALMAS,TO,200,213,413,889473,4110
107,CASCAVEL,PR,PORTO VELHO,RO,200,210,410,1216404,4110
108,CASCAVEL,PR,PRES PRUDENTE,SP,3513,9229,12742,5770852,4110
109,CASCAVEL,PR,RESENDE,RJ,87,81,168,198689,4110
110,CASCAVEL,PR,RIO BRANCO,AC,97,91,188,625288,4110
111,CASCAVEL,PR,RONDONOPOLIS,MT,1389,1818,3207,4011711,4110
112,CASCAVEL,PR,SAO JOSE DOS CAMPOS,SP,1836,2392,4228,4233651,4110
113,CASCAVEL,PR,UBERLANDIA,MG,201,332,533,607313,4110
114,CASCAVEL,PR,VOLTA REDONDA,RJ,47,44,91,111384,4110
115,CHAPECO,SC,ANAPOLIS,GO,17,25,42,73676,4110
116,CHAPECO,SC,CAMPINAS,SP,331,513,844,858686,4110
117,CHAPECO,SC,CASCAVEL,PR,1955,2364,4319,1617906,4110
118,CHAPECO,SC,FOZ DO IGUACU,PR,1301,1004,2305,1097579,4110
119,CHAPECO,SC,GOIANIA,GO,116,270,386,656547,4110
120,CHAPECO,SC,PALMAS,TO,47,48,95,242868,4110
121,CHAPECO,SC,PRES PRUDENTE,SP,762,85,847,762724,4110
122,CHAPECO,SC,SAO JOSE DO RIO PRETO,SP,159,132,291,339888,4110
123,CHAPECO,SC,UBERLANDIA,MG,51,34,85,123301,4110
124,COLATINA,ES,BARRA MANSA,RJ,154,118,272,207264,4110
125,COLATINA,ES,CUIABA,MT,81,86,167,377938,4110
126,COLATINA,ES,GOV VALADARES,MG,12615,14351,26966,6331617,4110
127,COLATINA,ES,ITABUNA,BA,2553,2401,4954,3437085,4110
128,COLATINA,ES,PORTO VELHO,RO,5248,7427,12675,47313240,4110
129,COLATINA,ES,SAO JOSE DOS CAMPOS,SP,310,213,523,509245,4110
130,COLATINA,ES,TEIXEIRA DE FREITAS,BA,679,728,1407,467828,4110
131,COLATINA,ES,UBERLANDIA,MG,41,45,86,103329,4110
132,CRATO,CE,CARUARU,PE,11,22,33,18094,4110
133,CRATO,CE,GOV VALADARES,MG,264,137,401,666061,4110
134,CRATO,CE,JOAO PESSOA,PB,684,742,1426,910216,4110
135,CRATO,CE,JUAZEIRO,BA,981,897,1878,654440,4110
136,CRATO,CE,MOSSORO,RN,7,10,17,7653,4110
137,CRATO,CE,NATAL,RN,982,1148,2130,1416158,4110
138,CRATO,CE,PETROLINA,PE,1055,1012,2067,715600,4110
139,CRATO,CE,SAO LUIS,MA,968,916,1884,1877783,4110
140,CRICIUMA,SC,CAMPINAS,SP,80,73,153,154545,4110
141,CRICIUMA,SC,CAMPO GRANDE,MS,135,98,233,361663,4110
142,CRICIUMA,SC,CASCAVEL,PR,1966,1376,3342,3192422,4110
143,CRICIUMA,SC,CUIABA,MT,121,82,203,456912,4110
144,CRICIUMA,SC,FOZ DO IGUACU,PR,2055,1557,3612,3784945,4110
145,CRICIUMA,SC,PORTO VELHO,RO,36,24,60,223230,4110
146,CRICIUMA,SC,RONDONOPOLIS,MT,86,72,158,322099,4110
147,CUIABA,MT,ARACATUBA,SP,1760,1818,3578,4188119,4110
148,CUIABA,MT,CAMPINAS,SP,4284,4077,8361,13290541,4110
149,CUIABA,MT,GOIANIA,GO,20689,17790,38479,36686244,4110
150,CUIABA,MT,JUIZ DE FORA,MG,90,106,196,362678,4110
151,CUIABA,MT,LONDRINA,PR,2459,2415,4874,6795331,4110
152,CUIABA,MT,MARINGA,PR,6166,6174,12340,16755252,4110
153,CUIABA,MT,PORTO VELHO,RO,6550,6139,12689,18651561,4110
154,CUIABA,MT,PRES PRUDENTE,SP,20554,20022,40576,47530726,4110
155,CUIABA,MT,RIO BRANCO,AC,2020,2330,4350,8528610,4110
156,CUIABA,MT,SAO JOSE DO RIO PRETO,SP,3573,3927,7500,9215547,4110
157,CUIABA,MT,UBERABA,MG,1857,1371,3228,3799679,4110
158,CUIABA,MT,UBERLANDIA,MG,6083,4518,10601,11376114,4110
159,FLORIANOPOLIS,SC,CAMPO GRANDE,MS,1883,1831,3714,5828752,4110
160,FLORIANOPOLIS,SC,CASCAVEL,PR,4379,3018,7397,6441087,4110
161,FLORIANOPOLIS,SC,CRICIUMA,SC,4613,5992,10605,2049947,4110
162,FLORIANOPOLIS,SC,FOZ DO IGUACU,PR,5375,4849,10224,10012686,4110
163,FLORIANOPOLIS,SC,GOV VALADARES,MG,35,8,43,72029,4110
164,FLORIANOPOLIS,SC,PASSO FUNDO,RS,1154,911,2065,1317883,4110
165,FLORIANOPOLIS,SC,PONTA GROSSA,PR,1834,1892,3726,1652413,4110
166,FLORIANOPOLIS,SC,TEOFILO OTONI,MG,19,2,21,37981,4110
167,FOZ DO IGUACU,PR,BARRA MANSA,RJ,800,608,1408,1937787,4110
168,FOZ DO IGUACU,PR,CAMPINAS,SP,3772,3672,7444,7802801,4110
169,FOZ DO IGUACU,PR,CAMPO GRANDE,MS,195,178,373,299967,4110
170,FOZ DO IGUACU,PR,CUIABA,MT,270,414,684,1027915,4110
171,FOZ DO IGUACU,PR,JUIZ DE FORA,MG,190,292,482,746232,4110
172,FOZ DO IGUACU,PR,RESENDE,RJ,481,200,681,901451,4110
173,FOZ DO IGUACU,PR,RONDONOPOLIS,MT,148,240,388,500753,4110
174,FOZ DO IGUACU,PR,SAO JOSE DOS CAMPOS,SP,2287,5165,7452,8576814,4110
175,FOZ DO IGUACU,PR,VOLTA REDONDA,RJ,75,54,129,175892,4110
176,GARANHUNS,PE,GOV VALADARES,MG,401,375,776,1274304,4110
177,GARANHUNS,PE,MACEIO,AL,5247,5157,10404,2059776,4110
178,GARANHUNS,PE,NATAL,RN,460,630,1090,573776,4110
179,GARANHUNS,PE,SAO JOSE DOS CAMPOS,SP,315,273,588,1448538,4110
180,GARANHUNS,PE,TEOFILO OTONI,MG,334,297,631,947396,4110
181,GARANHUNS,PE,VITORIA DA CONQUISTA,BA,501,446,947,1062608,4110
182,GARANHUNS,PE,VOLTA REDONDA,RJ,35,30,65,144632,4110
183,GOIANIA,GO,ARAGUARI,MG,8349,8808,17157,5360135,4110
184,GOIANIA,GO,BARRETOS,SP,7376,7850,15226,7730240,4110
185,GOIANIA,GO,CAMPINAS,SP,13802,13283,27085,23235320,4110
186,GOIANIA,GO,CASCAVEL,PR,1274,1316,2590,3616158,4110
187,GOIANIA,GO,FLORIANOPOLIS,SC,1484,939,2423,3788769,4110
188,GOIANIA,GO,FOZ DO IGUACU,PR,2567,2797,5364,8045464,4110
189,GOIANIA,GO,FRANCA,SP,6153,6708,12861,8144871,4110
190,GOIANIA,GO,LONDRINA,PR,4244,4466,8710,8505315,4110
191,GOIANIA,GO,MARINGA,PR,4770,5192,9962,10873716,4110
192,GOIANIA,GO,PALMAS,TO,2517,2718,5235,4483737,4110
193,GOIANIA,GO,PORTO VELHO,RO,2894,3598,6492,15668398,4110
194,GOIANIA,GO,RONDONOPOLIS,MT,10219,10408,20627,15207976,4110
195,GOIANIA,GO,SAO JOSE DO RIO PRETO,SP,12413,14975,27388,14716563,4110
196,GOIANIA,GO,SAO LUIS,MA,2881,2790,5671,11514556,4110
197,GOIANIA,GO,UBERABA,MG,13561,14193,27754,12820406,4110
198,GOIANIA,GO,UBERLANDIA,MG,41004,42755,83759,29402617,4110
199,GOIANIA,GO,VITORIA DA CONQUISTA,BA,248,180,428,530592,4110
200,GOV VALADARES,MG,ARACAJU,SE,179,229,408,504900,4110
201,GOV VALADARES,MG,CASCAVEL,PR,100,24,124,231198,4110
202,GOV VALADARES,MG,CUIABA,MT,746,559,1305,2587163,4110
203,GOV VALADARES,MG,FOZ DO IGUACU,PR,138,164,302,594396,4110
204,GOV VALADARES,MG,FRANCA,SP,72,95,167,129175,4110
205,GOV VALADARES,MG,GOIANIA,GO,235,182,417,492435,4110
206,GOV VALADARES,MG,ITABUNA,BA,348,499,847,656315,4110
207,GOV VALADARES,MG,JOAO PESSOA,PB,55,5,60,113538,4110
208,GOV VALADARES,MG,LONDRINA,PR,117,101,218,319719,4110
209,GOV VALADARES,MG,MARINGA,PR,133,144,277,435167,4110
210,GOV VALADARES,MG,NATAL,RN,6,19,25,51530,4110
211,GOV VALADARES,MG,PETROLINA,PE,96,323,419,561167,4110
212,GOV VALADARES,MG,PORTO VELHO,RO,188,121,309,1066730,4110
213,GOV VALADARES,MG,RONDONOPOLIS,MT,187,239,426,754148,4110
214,GOV VALADARES,MG,TEIXEIRA DE FREITAS,BA,692,460,1152,478886,4110
215,GOV VALADARES,MG,VITORIA,ES,36624,38595,75219,27816871,4110
216,GOV VALADARES,MG,VITORIA DA CONQUISTA,BA,317,419,736,388387,4110
217,ITABUNA,BA,FOZ DO IGUACU,PR,86,118,204,558389,4110
218,ITABUNA,BA,NITEROI,RJ,184,155,339,416326,4110
219,ITABUNA,BA,TEIXEIRA DE FREITAS,BA,3288,3889,7177,2657643,4110
220,ITABUNA,BA,VITORIA,ES,11423,11605,23028,17178155,4110
221,ITAJAI,SC,FLORIANOPOLIS,SC,16364,16848,33212,3450727,4110
222,ITAJAI,SC,JOINVILLE,SC,15238,14898,30136,3091954,4110
223,JOAO PESSOA,PB,ITABUNA,BA,57,11,68,84184,4110
224,JOAO PESSOA,PB,MOSSORO,RN,4194,3186,7380,3291480,4110
225,JOAO PESSOA,PB,TEOFILO OTONI,MG,83,53,136,230493,4110
226,JOAO PESSOA,PB,VITORIA,ES,81,224,305,605395,4110
227,JOINVILLE,SC,BLUMENAU,SC,2433,4198,6631,795201,4110
228,JOINVILLE,SC,CASCAVEL,PR,6617,4317,10934,7343905,4110
229,JOINVILLE,SC,FLORIANOPOLIS,SC,9625,10490,20115,3811793,4110
230,JOINVILLE,SC,FOZ DO IGUACU,PR,2510,2737,5247,4125716,4110
231,JOINVILLE,SC,GOV VALADARES,MG,66,9,75,111750,4110
232,JOINVILLE,SC,PONTA GROSSA,PR,2321,2680,5001,1291438,4110
233,JOINVILLE,SC,TEOFILO OTONI,MG,23,4,27,43835,4110
234,JUAZEIRO,BA,GOV VALADARES,MG,31,50,81,106985,4110
235,JUAZEIRO DO NORTE,CE,CAMPINA GRANDE,PB,117,60,177,90199,4110
236,JUAZEIRO DO NORTE,CE,GOV VALADARES,MG,238,81,319,553593,4110
237,JUAZEIRO DO NORTE,CE,JOAO PESSOA,PB,115,60,175,118808,4110
238,JUAZEIRO DO NORTE,CE,JUAZEIRO,BA,1244,1171,2415,936810,4110
239,JUAZEIRO DO NORTE,CE,MACEIO,AL,7198,7118,14316,10447252,4110
240,JUAZEIRO DO NORTE,CE,MOSSORO,RN,23,18,41,18175,4110
241,JUAZEIRO DO NORTE,CE,NATAL,RN,1715,1956,3671,2419556,4110
242,JUAZEIRO DO NORTE,CE,PETROLINA,PE,967,933,1900,728372,4110
243,JUAZEIRO DO NORTE,CE,SAO LUIS,MA,97,42,139,140890,4110
244,JUIZ DE FORA,MG,ANAPOLIS,GO,63,55,118,132136,4110
245,JUIZ DE FORA,MG,CABO FRIO,RJ,14842,17109,31951,10345734,4110
246,JUIZ DE FORA,MG,CACHOEIRO DO ITAPEMIRIM,ES,1474,1637,3111,1180936,4110
247,JUIZ DE FORA,MG,FLORIANOPOLIS,SC,282,239,521,702829,4110
248,JUIZ DE FORA,MG,ITABUNA,BA,130,124,254,315341,4110
249,JUIZ DE FORA,MG,ITAJAI,SC,52,66,118,148928,4110
250,JUIZ DE FORA,MG,JOINVILLE,SC,117,74,191,222305,4110
251,JUIZ DE FORA,MG,NITEROI,RJ,14264,13773,28037,5725155,4110
252,JUIZ DE FORA,MG,PALMAS,TO,200,184,384,743114,4110
253,JUIZ DE FORA,MG,SAO JOSE DOS CAMPOS,SP,6814,7931,14745,6197031,4110
254,JUIZ DE FORA,MG,TEIXEIRA DE FREITAS,BA,99,85,184,161957,4110
255,JUIZ DE FORA,MG,VITORIA,ES,6843,8329,15172,7836467,4110
256,JUIZ DE FORA,MG,VITORIA DA CONQUISTA,BA,261,179,440,436568,4110
257,LAGES,SC,CASCAVEL,PR,1074,1056,2130,1392471,4110
258,LAGES,SC,FOZ DO IGUACU,PR,978,885,1863,1404743,4110
259,LAGES,SC,PASSO FUNDO,RS,282,449,731,208774,4110
260,LONDRINA,PR,BARRA MANSA,RJ,162,144,306,254194,4110
261,LONDRINA,PR,BARRETOS,SP,454,487,941,559048,4110
262,LONDRINA,PR,CAMPINAS,SP,30894,31215,62109,33242086,4110
263,LONDRINA,PR,FLORIANOPOLIS,SC,6108,6624,12732,9285448,4110
264,LONDRINA,PR,FRANCA,SP,1097,883,1980,1122066,4110
265,LONDRINA,PR,JOINVILLE,SC,5355,5388,10743,5846341,4110
266,LONDRINA,PR,JUIZ DE FORA,MG,168,165,333,341258,4110
267,LONDRINA,PR,LAGES,SC,1023,721,1744,1403920,4110
268,LONDRINA,PR,NITEROI,RJ,328,344,672,648682,4110
269,LONDRINA,PR,PORTO VELHO,RO,92,84,176,500139,4110
270,LONDRINA,PR,PRES PRUDENTE,SP,14298,15824,30122,6948242,4110
271,LONDRINA,PR,RESENDE,RJ,65,84,149,118515,4110
272,LONDRINA,PR,SAO JOSE DOS CAMPOS,SP,7882,7040,14922,9138233,4110
273,LONDRINA,PR,UBERABA,MG,627,594,1221,861171,4110
274,MACEIO,AL,ANAPOLIS,GO,77,157,234,497840,4110
275,MACEIO,AL,CAMPINA GRANDE,PB,1067,1064,2131,717295,4110
276,MACEIO,AL,CRATO,CE,299,298,597,450786,4110
277,MACEIO,AL,FOZ DO IGUACU,PR,116,139,255,929458,4110
278,MACEIO,AL,GOIANIA,GO,760,1744,2504,5431641,4110
279,MACEIO,AL,GOV VALADARES,MG,393,281,674,1014235,4110
280,MACEIO,AL,ITABUNA,BA,475,430,905,883461,4110
281,MACEIO,AL,JOAO PESSOA,PB,3966,4167,8133,3001077,4110
282,MACEIO,AL,PALMAS,TO,227,104,331,636381,4110
283,MACEIO,AL,TEOFILO OTONI,MG,248,129,377,514718,4110
284,MACEIO,AL,VITORIA,ES,928,883,1811,3087031,4110
285,MARINGA,PR,BARRA MANSA,RJ,199,271,470,448783,4110
286,MARINGA,PR,BARRETOS,SP,364,356,720,511632,4110
287,MARINGA,PR,CAMPINAS,SP,25751,25493,51244,33436091,4110
288,MARINGA,PR,CAMPO GRANDE,MS,8590,10540,19130,12204671,4110
289,MARINGA,PR,FLORIANOPOLIS,SC,3834,3884,7718,6359632,4110
290,MARINGA,PR,FRANCA,SP,1893,1462,3355,2292136,4110
291,MARINGA,PR,JOINVILLE,SC,4095,3405,7500,4791750,4110
292,MARINGA,PR,JUIZ DE FORA,MG,151,245,396,451955,4110
293,MARINGA,PR,NITEROI,RJ,374,366,740,800532,4110
294,MARINGA,PR,PALMAS,TO,211,277,488,893333,4110
295,MARINGA,PR,PORTO VELHO,RO,263,133,396,1119690,4110
296,MARINGA,PR,PRES PRUDENTE,SP,52186,53985,106171,23001237,4110
297,MARINGA,PR,RESENDE,RJ,64,42,106,96661,4110
298,MARINGA,PR,RONDONOPOLIS,MT,6043,6131,12174,13946534,4110
299,MARINGA,PR,SAO JOSE DOS CAMPOS,SP,8726,7039,15765,11730055,4110
300,MARINGA,PR,UBERABA,MG,721,710,1431,1148058,4110
301,MOSSORO,RN,ARACAJU,SE,303,11,314,335509,4110
302,MOSSORO,RN,CAMPINA GRANDE,PB,1239,740,1979,922412,4110
303,MOSSORO,RN,GOV VALADARES,MG,122,69,191,389545,4110
304,MOSSORO,RN,MACEIO,AL,165,118,283,225325,4110
305,MOSSORO,RN,VITORIA DA CONQUISTA,BA,446,167,613,927959,4110
306,NATAL,RN,CAMPINA GRANDE,PB,25295,23340,48635,14073408,4110
307,NATAL,RN,GOIANIA,GO,408,448,856,2486166,4110
308,NATAL,RN,JOAO PESSOA,PB,60797,53578,114375,20987813,4110
309,NATAL,RN,MACEIO,AL,5481,5438,10919,6694439,4110
310,NATAL,RN,SAO JOSE DOS CAMPOS,SP,473,401,874,2468001,4110
311,NITEROI,RJ,CASCAVEL,PR,160,145,305,411506,4110
312,NITEROI,RJ,FOZ DO IGUACU,PR,152,729,881,1311545,4110
313,PALMAS,TO,ARAGUARI,MG,414,199,613,707218,4110
314,PALMAS,TO,PATOS DE MINAS,MG,154,169,323,447775,4110
315,PALMAS,TO,SAO LUIS,MA,375,505,880,1091992,4110
316,PARNAIBA,PI,GOIANIA,GO,831,995,1826,4136438,4110
317,PASSO FUNDO,RS,ANAPOLIS,GO,1,1,2,3390,4110
318,PASSO FUNDO,RS,BLUMENAU,SC,110,125,235,118017,4110
319,PASSO FUNDO,RS,CASCAVEL,PR,6235,5769,12004,6923337,4110
320,PASSO FUNDO,RS,CHAPECO,SC,8604,9081,17685,3144508,4110
321,PASSO FUNDO,RS,FOZ DO IGUACU,PR,1671,1629,3300,2209596,4110
322,PASSO FUNDO,RS,GOIANIA,GO,56,41,97,159255,4110
323,PASSO FUNDO,RS,PONTA GROSSA,PR,102,57,159,84858,4110
324,PASSO FUNDO,RS,SAO JOSE DO RIO PRETO,SP,107,47,154,171125,4110
325,PASSO FUNDO,RS,UBERLANDIA,MG,42,8,50,69575,4110
326,PATOS DE MINAS,MG,ARACAJU,SE,76,75,151,244061,4110
327,PATOS DE MINAS,MG,CAMPINAS,SP,1360,1537,2897,2122203,4110
328,PATOS DE MINAS,MG,FRANCA,SP,3375,3353,6728,2795915,4110
329,PATOS DE MINAS,MG,GOIANIA,GO,4368,3820,8188,4413556,4110
330,PATOS DE MINAS,MG,MACEIO,AL,44,58,102,192127,4110
331,PATOS DE MINAS,MG,VITORIA DA CONQUISTA,BA,153,119,272,246568,4110
332,PETROLINA,PE,GOIANIA,GO,101,480,581,1041036,4110
333,PETROLINA,PE,JUAZEIRO,BA,710687,710629,1421316,26294346,4110
334,PETROLINA,PE,MACEIO,AL,125,135,260,202878,4110
335,PONTA GROSSA,PR,ARACATUBA,SP,455,447,902,505842,4110
336,PONTA GROSSA,PR,BARRA MANSA,RJ,281,266,547,461887,4110
337,PONTA GROSSA,PR,CAMPO GRANDE,MS,51,39,90,84105,4110
338,PONTA GROSSA,PR,CUIABA,MT,88,102,190,310289,4110
339,PONTA GROSSA,PR,GOIANIA,GO,28,37,65,72482,4110
340,PONTA GROSSA,PR,PALMAS,TO,47,64,111,218870,4110
341,PONTA GROSSA,PR,PORTO VELHO,RO,29,16,45,139626,4110
342,PONTA GROSSA,PR,PRES PRUDENTE,SP,1312,1055,2367,1166221,4110
343,PONTA GROSSA,PR,RESENDE,RJ,39,30,69,55117,4110
344,PONTA GROSSA,PR,RONDONOPOLIS,MT,34,25,59,83833,4110
345,PONTA GROSSA,PR,SAO JOSE DOS CAMPOS,SP,858,1019,1877,1175190,4110
346,PONTA GROSSA,PR,UBERLANDIA,MG,9,43,52,44970,4110
347,PORTO VELHO,RO,RIO BRANCO,AC,47735,50865,98600,49073220,4110
348,PORTO VELHO,RO,RONDONOPOLIS,MT,500,606,1106,1867923,4110
349,POUSO ALEGRE,MG,BRAGANCA PAULISTA,SP,8078,5902,13980,1852350,4110
350,POUSO ALEGRE,MG,CAMPINAS,SP,8031,11216,19247,3739408,4110
351,POUSO ALEGRE,MG,VARGINHA,MG,18202,20290,38492,4688326,4110
352,PRES PRUDENTE,SP,ARAGUARI,MG,188,288,476,313160,4110
353,PRES PRUDENTE,SP,BARRA MANSA,RJ,1518,1501,3019,2655814,4110
354,PRES PRUDENTE,SP,CAMPO GRANDE,MS,16555,19593,36148,17090774,4110
355,PRES PRUDENTE,SP,JUIZ DE FORA,MG,48,55,103,119944,4110
356,PRES PRUDENTE,SP,PALMAS,TO,302,319,621,1033841,4110
357,PRES PRUDENTE,SP,PORTO VELHO,RO,3373,2736,6109,16134480,4110
358,PRES PRUDENTE,SP,RONDONOPOLIS,MT,11166,10601,21767,20878906,4110
359,PRES PRUDENTE,SP,UBERLANDIA,MG,1721,1996,3717,2333904,4110
360,RESENDE,RJ,JUIZ DE FORA,MG,1529,1989,3518,856281,4110
361,RESENDE,RJ,SAO JOSE DOS CAMPOS,SP,2744,2499,5243,961566,4110
362,RESENDE,RJ,VITORIA DA CONQUISTA,BA,435,347,782,914705,4110
363,RONDONOPOLIS,MT,ANAPOLIS,GO,353,387,740,586376,4110
364,RONDONOPOLIS,MT,ARACATUBA,SP,244,249,493,471505,4110
365,RONDONOPOLIS,MT,CAMPINAS,SP,2704,2605,5309,7314168,4110
366,RONDONOPOLIS,MT,JUIZ DE FORA,MG,70,40,110,180202,4110
367,RONDONOPOLIS,MT,LONDRINA,PR,471,545,1016,1200912,4110
368,RONDONOPOLIS,MT,RIO BRANCO,AC,281,533,814,1774194,4110
369,RONDONOPOLIS,MT,SAO JOSE DO RIO PRETO,SP,2633,2821,5454,5542146,4110
370,RONDONOPOLIS,MT,UBERABA,MG,296,379,675,651308,4110
371,RONDONOPOLIS,MT,UBERLANDIA,MG,2577,1372,3949,3382713,4110
372,SAO JOSE DO RIO PRETO,SP,ARACAJU,SE,1144,924,2068,4467707,4110
373,SAO JOSE DO RIO PRETO,SP,ARAGUARI,MG,450,533,983,378225,4110
374,SAO JOSE DO RIO PRETO,SP,FLORIANOPOLIS,SC,1001,790,1791,1844883,4110
375,SAO JOSE DO RIO PRETO,SP,FOZ DO IGUACU,PR,2026,2339,4365,4220955,4110
376,SAO JOSE DO RIO PRETO,SP,GOV VALADARES,MG,131,422,553,588392,4110
377,SAO JOSE DO RIO PRETO,SP,JUIZ DE FORA,MG,2631,1295,3926,3319826,4110
378,SAO JOSE DO RIO PRETO,SP,LONDRINA,PR,5561,5926,11487,4878190,4110
379,SAO JOSE DO RIO PRETO,SP,MACEIO,AL,1187,1234,2421,5877462,4110
380,SAO JOSE DO RIO PRETO,SP,MARINGA,PR,1513,2015,3528,1979623,4110
381,SAO JOSE DO RIO PRETO,SP,PALMAS,TO,1484,1048,2532,3525388,4110
382,SAO JOSE DO RIO PRETO,SP,PATOS DE MINAS,MG,548,439,987,561702,4110
383,SAO JOSE DO RIO PRETO,SP,POUSO ALEGRE,MG,435,302,737,365331,4110
384,SAO JOSE DO RIO PRETO,SP,PRES PRUDENTE,SP,1889,2311,4200,1160460,4110
385,SAO JOSE DO RIO PRETO,SP,TEOFILO OTONI,MG,175,513,688,823880,4110
386,SAO JOSE DO RIO PRETO,SP,UBERABA,MG,6248,3985,10233,2738351,4110
387,SAO JOSE DO RIO PRETO,SP,UBERLANDIA,MG,7451,7286,14737,5152137,4110
388,SAO JOSE DO RIO PRETO,SP,VITORIA DA CONQUISTA,BA,1972,1333,3305,4794233,4110
389,SAO JOSE DOS CAMPOS,SP,GOV VALADARES,MG,1194,742,1936,1608485,4110
390,SAO JOSE DOS CAMPOS,SP,ITAJAI,SC,633,608,1241,942224,4110
391,SAO JOSE DOS CAMPOS,SP,JOINVILLE,SC,587,333,920,608089,4110
392,SAO JOSE DOS CAMPOS,SP,PARNAIBA,PI,374,22,396,1304266,4110
393,SAO JOSE DOS CAMPOS,SP,PETROLINA,PE,3,47,50,111685,4110
394,SAO JOSE DOS CAMPOS,SP,POUSO ALEGRE,MG,18663,18909,37572,6221923,4110
395,SAO JOSE DOS CAMPOS,SP,TEOFILO OTONI,MG,1317,1601,2918,2831493,4110
396,SAO JOSE DOS CAMPOS,SP,TERESINA,PI,1260,326,1586,4601591,4110
397,SAO LUIS,MA,CAMPINA GRANDE,PB,1166,1153,2319,3504473,4110
398,SAO LUIS,MA,JOAO PESSOA,PB,1386,1375,2761,4508713,4110
399,SAO LUIS,MA,NATAL,RN,1169,1165,2334,4180739,4110
400,SAO LUIS,MA,PARNAIBA,PI,6105,6006,12111,5890790,4110
401,TEIXEIRA DE FREITAS,BA,FOZ DO IGUACU,PR,114,127,241,572565,4110
402,TEIXEIRA DE FREITAS,BA,GOIANIA,GO,380,351,731,1213241,4110
403,TEIXEIRA DE FREITAS,BA,NITEROI,RJ,75,86,161,139555,4110
404,TEIXEIRA DE FREITAS,BA,VARGINHA,MG,70,56,126,131456,4110
405,TEIXEIRA DE FREITAS,BA,VITORIA,ES,40148,43653,83801,31157626,4110
406,TEOFILO OTONI,MG,ARACAJU,SE,185,221,406,445788,4110
407,TEOFILO OTONI,MG,CAMPINAS,SP,1686,2409,4095,4696146,4110
408,TEOFILO OTONI,MG,CASCAVEL,PR,93,41,134,267732,4110
409,TEOFILO OTONI,MG,FOZ DO IGUACU,PR,135,173,308,647324,4110
410,TEOFILO OTONI,MG,FRANCA,SP,495,487,982,890674,4110
411,TEOFILO OTONI,MG,ITABUNA,BA,43,184,227,144713,4110
412,TEOFILO OTONI,MG,LONDRINA,PR,84,91,175,280018,4110
413,TEOFILO OTONI,MG,MARINGA,PR,94,106,200,340900,4110
414,TEOFILO OTONI,MG,MOSSORO,RN,2,5,7,15289,4110
415,TEOFILO OTONI,MG,NATAL,RN,8,13,21,40356,4110
416,TEOFILO OTONI,MG,TEIXEIRA DE FREITAS,BA,305,458,763,210741,4110
417,TEOFILO OTONI,MG,VITORIA DA CONQUISTA,BA,985,1124,2109,818714,4110
418,TERESINA,PI,ANAPOLIS,GO,52,66,118,238030,4110
419,TERESINA,PI,CAMPINA GRANDE,PB,54,420,474,516139,4110
420,TERESINA,PI,GOIANIA,GO,286,252,538,1038770,4110
421,TERESINA,PI,JOAO PESSOA,PB,88,280,368,452591,4110
422,TERESINA,PI,JUAZEIRO DO NORTE,CE,1172,1540,2712,1594076,4110
423,TERESINA,PI,MACEIO,AL,505,474,979,1281119,4110
424,TERESINA,PI,MOSSORO,RN,135,124,259,220245,4110
425,TERESINA,PI,NATAL,RN,1034,1033,2067,2812585,4110
426,TERESINA,PI,PALMAS,TO,809,686,1495,1797738,4110
427,TERESINA,PI,PETROLINA,PE,3503,4657,8160,5148960,4110
428,TERESINA,PI,SAO LUIS,MA,26420,26748,53168,22771854,4110
429,UBERABA,MG,ARACAJU,SE,128,137,265,537924,4110
430,UBERABA,MG,ARACATUBA,SP,13,14,27,11486,4110
431,UBERABA,MG,BARRA MANSA,RJ,351,347,698,538577,4110
432,UBERABA,MG,BARRETOS,SP,4389,4445,8834,1390206,4110
433,UBERABA,MG,CAMPINAS,SP,9921,7782,17703,7247608,4110
434,UBERABA,MG,CAMPO GRANDE,MS,740,771,1511,1519455,4110
435,UBERABA,MG,CASCAVEL,PR,311,289,600,619380,4110
436,UBERABA,MG,FOZ DO IGUACU,PR,554,706,1260,1476468,4110
437,UBERABA,MG,FRANCA,SP,32475,32501,64976,9051157,4110
438,UBERABA,MG,MACEIO,AL,209,417,626,1438047,4110
439,UBERABA,MG,PONTA GROSSA,PR,75,64,139,111436,4110
440,UBERABA,MG,PORTO VELHO,RO,47,64,111,294794,4110
441,UBERABA,MG,PRES PRUDENTE,SP,902,636,1538,836672,4110
442,UBERABA,MG,SAO JOSE DOS CAMPOS,SP,1102,1850,2952,1633342,4110
443,UBERABA,MG,SAO LUIS,MA,266,100,366,952918,4110
444,UBERABA,MG,VITORIA DA CONQUISTA,BA,256,236,492,649489,4110
445,UBERLANDIA,MG,ARACAJU,SE,289,345,634,1151407,4110
446,UBERLANDIA,MG,BARRA MANSA,RJ,860,967,1827,1611597,4110
447,UBERLANDIA,MG,CAMPINAS,SP,9486,7912,17398,9045220,4110
448,UBERLANDIA,MG,FLORIANOPOLIS,SC,31,139,170,228055,4110
449,UBERLANDIA,MG,FOZ DO IGUACU,PR,349,316,665,861441,4110
450,UBERLANDIA,MG,FRANCA,SP,6701,5696,12397,3332314,4110
451,UBERLANDIA,MG,JOINVILLE,SC,29,114,143,165365,4110
452,UBERLANDIA,MG,MACEIO,AL,1016,1435,2451,5106413,4110
453,UBERLANDIA,MG,PORTO VELHO,RO,940,1102,2042,5201995,4110
454,UBERLANDIA,MG,SAO JOSE DOS CAMPOS,SP,1203,1655,2858,1897140,4110
455,UBERLANDIA,MG,SAO LUIS,MA,178,185,363,905794,4110
456,UBERLANDIA,MG,VITORIA DA CONQUISTA,BA,1690,1684,3374,3732656,4110
457,VITORIA,ES,ARACAJU,SE,1301,1485,2786,3815706,4110
458,VITORIA,ES,BARRA MANSA,RJ,672,790,1462,927631,4110
459,VITORIA,ES,CUIABA,MT,108,146,254,541452,4110
460,VITORIA,ES,FOZ DO IGUACU,PR,153,238,391,796352,4110
461,VITORIA,ES,NITEROI,RJ,13480,13516,26996,13667137,4110
462,VITORIA,ES,PARNAIBA,PI,105,103,208,513531,4110
463,VITORIA,ES,PORTO VELHO,RO,272,232,504,1815106,4110
464,VITORIA,ES,SAO JOSE DOS CAMPOS,SP,1042,1557,2599,2195554,4110
465,VITORIA,ES,TEOFILO OTONI,MG,5020,4753,9773,5358536,4110
466,VITORIA,ES,TERESINA,PI,314,158,472,1007223,4110
467,VITORIA,ES,UBERLANDIA,MG,72,78,150,160515,4110
468,VITORIA,ES,VITORIA DA CONQUISTA,BA,2170,2072,4242,3959907,4110
469,VITORIA,ES,VOLTA REDONDA,RJ,281,795,1076,677507,4110
470,VITORIA DA CONQUISTA,BA,ARACAJU,SE,3077,2599,5676,4040177,4110
471,VITORIA DA CONQUISTA,BA,CASCAVEL,PR,140,66,206,490939,4110
472,VITORIA DA CONQUISTA,BA,FOZ DO IGUACU,PR,218,167,385,957457,4110
473,VITORIA DA CONQUISTA,BA,FRANCA,SP,86,140,226,292037,4110
474,VITORIA DA CONQUISTA,BA,LONDRINA,PR,460,276,736,1461181,4110
475,VITORIA DA CONQUISTA,BA,MACEIO,AL,678,1005,1683,1648527,4110
476,VITORIA DA CONQUISTA,BA,MARINGA,PR,220,314,534,1115900,4110
477,VITORIA DA CONQUISTA,BA,SAO JOSE DOS CAMPOS,SP,250,348,598,806283,4110
478,VITORIA DA CONQUISTA,BA,VOLTA REDONDA,RJ,83,79,162,182768,4110
479,VOLTA REDONDA,RJ,JUIZ DE FORA,MG,6847,5494,12341,2491648,4110
480,VOLTA REDONDA,RJ,SAO JOSE DOS CAMPOS,SP,10286,11673,21959,5022023,4110
1,BELEM,PA,ANAPOLIS,GO,1043,1406,2449,4815652,4111
2,BELEM,PA,ARACAJU,SE,1255,1383,2638,6082173,4111
3,BELEM,PA,CAMPINA GRANDE,PB,472,535,1007,2014806,4111
4,BELEM,PA,CAMPINAS,SP,48,76,124,356847,4111
5,BELEM,PA,CARUARU,PE,960,901,1861,3553207,4111
6,BELEM,PA,GOIANIA,GO,2773,2880,5653,11251010,4111
7,BELEM,PA,JOAO PESSOA,PB,932,946,1878,4013952,4111
8,BELEM,PA,JUAZEIRO DO NORTE,CE,798,850,1648,2477274,4111
9,BELEM,PA,MACEIO,AL,1709,1611,3320,7372060,4111
10,BELEM,PA,MOSSORO,RN,208,185,393,699758,4111
11,BELEM,PA,NATAL,RN,2187,2132,4319,8903653,4111
12,BELEM,PA,PARNAIBA,PI,1792,1720,3512,4011406,4111
13,BELEM,PA,PETROLINA,PE,220,427,647,998256,4111
14,BELEM,PA,SAO LUIS,MA,11845,11878,23723,18658140,4111
15,BELEM,PA,TERESINA,PI,7561,11013,18574,16982208,4111
16,BELEM,PA,UBERABA,MG,95,88,183,452632,4111
17,BELEM,PA,UBERLANDIA,MG,79,120,199,470655,4111
18,BELO HORIZONTE,MG,ANAPOLIS,GO,2465,2920,5385,5174985,4111
19,BELO HORIZONTE,MG,ARACAJU,SE,2760,2072,4832,7526108,4111
20,BELO HORIZONTE,MG,ARACATUBA,SP,123,436,559,502485,4111
21,BELO HORIZONTE,MG,BARRA MANSA,RJ,13785,13865,27650,12622979,4111
22,BELO HORIZONTE,MG,BARRETOS,SP,2831,3038,5869,3886452,4111
23,BELO HORIZONTE,MG,CABO FRIO,RJ,31813,32248,64061,36514770,4111
24,BELO HORIZONTE,MG,CACHOEIRO DO ITAPEMIRIM,ES,5779,5847,11626,5682410,4111
25,BELO HORIZONTE,MG,CAMPINAS,SP,30448,34862,65310,40835187,4111
26,BELO HORIZONTE,MG,CAMPO GRANDE,MS,5925,6558,12483,17976776,4111
27,BELO HORIZONTE,MG,CASCAVEL,PR,1115,1194,2309,3517736,4111
28,BELO HORIZONTE,MG,CUIABA,MT,2029,1485,3514,5639267,4111
29,BELO HORIZONTE,MG,FOZ DO IGUACU,PR,4123,4400,8523,14090324,4111
30,BELO HORIZONTE,MG,FRANCA,SP,7208,7374,14582,6570649,4111
31,BELO HORIZONTE,MG,GOIANIA,GO,30596,32889,63485,56809815,4111
32,BELO HORIZONTE,MG,ITABUNA,BA,2159,2211,4370,4789520,4111
33,BELO HORIZONTE,MG,JOAO PESSOA,PB,250,244,494,1092382,4111
34,BELO HORIZONTE,MG,JUAZEIRO,BA,246,357,603,1050667,4111
35,BELO HORIZONTE,MG,LONDRINA,PR,31,36,67,87565,4111
36,BELO HORIZONTE,MG,MACEIO,AL,2602,1901,4503,8221523,4111
37,BELO HORIZONTE,MG,MARINGA,PR,1894,1960,3854,4782426,4111
38,BELO HORIZONTE,MG,MOSSORO,RN,753,490,1243,2983134,4111
39,BELO HORIZONTE,MG,NATAL,RN,8288,5480,13768,32189666,4111
40,BELO HORIZONTE,MG,NITEROI,RJ,11064,12601,23665,10658716,4111
41,BELO HORIZONTE,MG,PALMAS,TO,2216,2433,4649,7409257,4111
42,BELO HORIZONTE,MG,PETROLINA,PE,529,195,724,1200609,4111
43,BELO HORIZONTE,MG,PORTO VELHO,RO,53,40,93,285929,4111
44,BELO HORIZONTE,MG,PRESIDENTE PRUDENTE,SP,2503,3110,5613,5506471,4111
45,BELO HORIZONTE,MG,RESENDE,RJ,1295,876,2171,1062922,4111
46,BELO HORIZONTE,MG,RONDONOPOLIS,MT,958,719,1677,2335390,4111
47,BELO HORIZONTE,MG,SAO JOSE DO RIO PRETO,SP,8733,8107,16840,12480124,4111
48,BELO HORIZONTE,MG,SAO JOSE DOS CAMPOS,SP,8776,8831,17607,10909694,4111
49,BELO HORIZONTE,MG,TEIXEIRA DE FREITAS,BA,14571,12478,27049,19898394,4111
50,BELO HORIZONTE,MG,VITORIA,ES,58290,63550,121840,64818880,4111
51,BELO HORIZONTE,MG,VITORIA DA CONQUISTA,BA,8341,13092,21433,18177231,4111
52,CURITIBA,PR,ARACAJU,SE,792,737,1529,4198640,4111
53,CURITIBA,PR,ARACATUBA,SP,2474,2272,4746,3226331,4111
54,CURITIBA,PR,BARRA MANSA,RJ,426,378,804,604608,4111
55,CURITIBA,PR,BLUMENAU,SC,31224,29097,60321,14024168,4111
56,CURITIBA,PR,CAMPINAS,SP,31586,29851,61437,38779145,4111
57,CURITIBA,PR,CAMPO GRANDE,MS,23454,27897,51351,54408266,4111
58,CURITIBA,PR,CHAPECO,SC,13360,11076,24436,11736352,4111
59,CURITIBA,PR,CRICIUMA,SC,7421,6254,13675,6817376,4111
60,CURITIBA,PR,CUIABA,MT,10172,13016,23188,40771127,4111
61,CURITIBA,PR,FLORIANOPOLIS,SC,67970,70147,138117,43783089,4111
62,CURITIBA,PR,GOIANIA,GO,6508,6284,12792,15844591,4111
63,CURITIBA,PR,ITABUNA,BA,460,591,1051,2216320,4111
64,CURITIBA,PR,ITAJAI,SC,30170,31618,61788,14217419,4111
65,CURITIBA,PR,JOINVILLE,SC,148949,142397,291346,38472705,4111
66,CURITIBA,PR,LAGES,SC,13414,12773,26187,9524212,4111
67,CURITIBA,PR,MACEIO,AL,818,889,1707,5148771,4111
68,CURITIBA,PR,PASSO FUNDO,RS,4807,3886,8693,4850820,4111
69,CURITIBA,PR,PORTO VELHO,RO,314,137,451,1467517,4111
70,CURITIBA,PR,PRESIDENTE PRUDENTE,SP,16361,18216,34577,21150751,4111
71,CURITIBA,PR,RESENDE,RJ,581,560,1141,817755,4111
72,CURITIBA,PR,RONDONOPOLIS,MT,479,457,936,1443187,4111
73,CURITIBA,PR,SAO JOSE DO RIO PRETO,SP,6350,4882,11232,7922744,4111
74,CURITIBA,PR,SAO JOSE DOS CAMPOS,SP,3574,3366,6940,3703878,4111
75,CURITIBA,PR,TEIXEIRA DE FREITAS,BA,457,468,925,1616325,4111
76,CURITIBA,PR,TEOFILO OTONI,MG,33,8,41,61352,4111
77,CURITIBA,PR,UBERABA,MG,358,304,662,609852,4111
78,CURITIBA,PR,UBERLANDIA,MG,296,299,595,614264,4111
79,CURITIBA,PR,VOLTA REDONDA,RJ,1372,1356,2728,2076368,4111
80,FORTALEZA,CE,ARACAJU,SE,2713,231,2944,3871360,4111
81,FORTALEZA,CE,CAMPINA GRANDE,PB,7639,7167,14806,10549275,4111
82,FORTALEZA,CE,GARANHUNS,PE,678,11,689,563189,4111
83,FORTALEZA,CE,GOIANIA,GO,332,318,650,1696305,4111
84,FORTALEZA,CE,GOVERNADOR VALADARES,MG,498,496,994,2144257,4111
85,FORTALEZA,CE,ITAJAI,SC,395,368,763,2850873,4111
86,FORTALEZA,CE,JOAO PESSOA,PB,8703,7964,16667,11540231,4111
87,FORTALEZA,CE,JOINVILLE,SC,236,193,429,1560788,4111
88,FORTALEZA,CE,MACEIO,AL,3482,1843,5325,5552377,4111
89,FORTALEZA,CE,MOSSORO,RN,17215,15229,32444,8188866,4111
90,FORTALEZA,CE,NATAL,RN,51112,45075,96187,51738987,4111
91,FORTALEZA,CE,NITEROI,RJ,1075,637,1712,4817054,4111
92,FORTALEZA,CE,PALMAS,TO,815,869,1684,3401343,4111
93,FORTALEZA,CE,PARNAIBA,PI,24935,24821,49756,24535188,4111
94,FORTALEZA,CE,PETROLINA,PE,3032,792,3824,3243468,4111
95,FORTALEZA,CE,SAO JOSE DOS CAMPOS,SP,445,687,1132,3370870,4111
96,FORTALEZA,CE,SAO LUIS,MA,16231,16405,32636,33438492,4111
97,FORTALEZA,CE,TEOFILO OTONI,MG,250,229,479,966478,4111
98,FORTALEZA,CE,TERESINA,PI,33153,41711,74864,44873482,4111
99,FORTALEZA,CE,VITORIA,ES,1691,1662,3353,7775272,4111
100,FORTALEZA,CE,VITORIA DA CONQUISTA,BA,1642,1667,3309,5398674,4111
101,FORTALEZA,CE,VOLTA REDONDA,RJ,173,228,401,1105838,4111
102,PORTO ALEGRE,RS,BLUMENAU,SC,10269,9349,19618,11620810,4111
103,PORTO ALEGRE,RS,CAMPINAS,SP,4444,3695,8139,10456173,4111
104,PORTO ALEGRE,RS,CAMPO GRANDE,MS,190,211,401,732547,4111
105,PORTO ALEGRE,RS,CASCAVEL,PR,8870,10553,19423,16798598,4111
106,PORTO ALEGRE,RS,CHAPECO,SC,12845,13656,26501,12558824,4111
107,PORTO ALEGRE,RS,CRICIUMA,SC,42647,44012,86659,25703059,4111
108,PORTO ALEGRE,RS,CUIABA,MT,175,157,332,838433,4111
109,PORTO ALEGRE,RS,FLORIANOPOLIS,SC,132954,108951,241905,113187350,4111
110,PORTO ALEGRE,RS,FOZ DO IGUACU,PR,5760,5836,11596,11002023,4111
111,PORTO ALEGRE,RS,GOIANIA,GO,1279,1590,2869,5791136,4111
112,PORTO ALEGRE,RS,ITAJAI,SC,11257,9810,21067,11746959,4111
113,PORTO ALEGRE,RS,JOINVILLE,SC,11034,10674,21708,13962586,4111
114,PORTO ALEGRE,RS,LAGES,SC,6495,7065,13560,4826004,4111
115,PORTO ALEGRE,RS,LONDRINA,PR,3342,3157,6499,7468865,4111
116,PORTO ALEGRE,RS,MARINGA,PR,1976,1778,3754,4796486,4111
117,PORTO ALEGRE,RS,PASSO FUNDO,RS,314,190,504,145908,4111
118,PORTO ALEGRE,RS,PONTA GROSSA,PR,504,537,1041,934993,4111
119,PORTO ALEGRE,RS,PORTO VELHO,RO,80,47,127,507378,4111
120,PORTO ALEGRE,RS,PRESIDENTE PRUDENTE,SP,363,720,1083,1475912,4111
121,PORTO ALEGRE,RS,RESENDE,RJ,48,11,59,87473,4111
122,PORTO ALEGRE,RS,RONDONOPOLIS,MT,113,99,212,490398,4111
123,PORTO ALEGRE,RS,SAO JOSE DO RIO PRETO,SP,1159,1407,2566,3803838,4111
124,PORTO ALEGRE,RS,SAO JOSE DOS CAMPOS,SP,1102,1014,2116,2750793,4111
125,PORTO ALEGRE,RS,TEOFILO OTONI,MG,28,5,33,74656,4111
126,RECIFE,PE,ANAPOLIS,GO,218,268,486,1166225,4111
127,RECIFE,PE,ARACAJU,SE,21819,21489,43308,21446122,4111
128,RECIFE,PE,BARRETOS,SP,55,53,108,293101,4111
129,RECIFE,PE,CAMPINA GRANDE,PB,79096,78583,157679,38490359,4111
130,RECIFE,PE,CRATO,CE,13821,10571,24392,16308491,4111
131,RECIFE,PE,FOZ DO IGUACU,PR,340,317,657,2536451,4111
132,RECIFE,PE,GARANHUNS,PE,3054,3018,6072,1354663,4111
133,RECIFE,PE,GOIANIA,GO,1718,1812,3530,8625061,4111
134,RECIFE,PE,GOVERNADOR VALADARES,MG,165,209,374,657279,4111
135,RECIFE,PE,JOAO PESSOA,PB,107826,80356,188182,24200205,4111
136,RECIFE,PE,JUAZEIRO,BA,10934,10715,21649,16429426,4111
137,RECIFE,PE,JUAZEIRO DO NORTE,CE,4656,5527,10183,6738091,4111
138,RECIFE,PE,MACEIO,AL,90091,88441,178532,47445478,4111
139,RECIFE,PE,MOSSORO,RN,3671,3213,6884,3855040,4111
140,RECIFE,PE,NATAL,RN,113910,114426,228336,67929960,4111
141,RECIFE,PE,PALMAS,TO,497,154,651,1392033,4111
142,RECIFE,PE,PATOS DE MINAS,MG,46,53,99,209543,4111
143,RECIFE,PE,SAO JOSE DO RIO PRETO,SP,1120,1017,2137,5691860,4111
144,RECIFE,PE,SAO LUIS,MA,5853,5782,11635,17959786,4111
145,RECIFE,PE,TEOFILO OTONI,MG,74,117,191,307854,4111
146,RECIFE,PE,TERESINA,PI,15917,13659,29576,33057095,4111
147,RECIFE,PE,UBERABA,MG,120,242,362,915932,4111
148,RECIFE,PE,UBERLANDIA,MG,542,806,1348,3122507,4111
149,RECIFE,PE,VITORIA,ES,277,720,997,1868478,4111
150,RECIFE,PE,VITORIA DA CONQUISTA,BA,1170,1335,2505,3051212,4111
151,SALVADOR,BA,ARACAJU,SE,106519,102833,209352,66141401,4111
152,SALVADOR,BA,CAMPINA GRANDE,PB,4895,4228,9123,7795056,4111
153,SALVADOR,BA,CAMPINAS,SP,4244,5108,9352,19099590,4111
154,SALVADOR,BA,CARUARU,PE,5520,5774,11294,8219984,4111
155,SALVADOR,BA,CASCAVEL,PR,148,76,224,648144,4111
156,SALVADOR,BA,FOZ DO IGUACU,PR,2953,3228,6181,18525693,4111
157,SALVADOR,BA,FRANCA,SP,80,94,174,313635,4111
158,SALVADOR,BA,GARANHUNS,PE,300,309,609,412719,4111
159,SALVADOR,BA,GOIANIA,GO,9590,8826,18416,31344032,4111
160,SALVADOR,BA,GOVERNADOR VALADARES,MG,539,712,1251,1298538,4111
161,SALVADOR,BA,JOAO PESSOA,PB,9213,8250,17463,15926256,4111
162,SALVADOR,BA,JUAZEIRO DO NORTE,CE,223,551,774,772994,4111
163,SALVADOR,BA,JUIZ DE FORA,MG,590,581,1171,1759428,4111
164,SALVADOR,BA,LONDRINA,PR,292,279,571,1424988,4111
165,SALVADOR,BA,MACEIO,AL,8106,7448,15554,9516040,4111
166,SALVADOR,BA,MARINGA,PR,202,183,385,1001000,4111
167,SALVADOR,BA,NATAL,RN,3220,2640,5860,6649642,4111
168,SALVADOR,BA,PALMAS,TO,2304,2249,4553,6614598,4111
169,SALVADOR,BA,PETROLINA,PE,4183,4194,8377,4286511,4111
170,SALVADOR,BA,TEOFILO OTONI,MG,395,539,934,839199,4111
171,SALVADOR,BA,TERESINA,PI,3939,3440,7379,8312444,4111
172,SALVADOR,BA,UBERABA,MG,204,190,394,721178,4111
173,SALVADOR,BA,VITORIA,ES,9505,8407,17912,20958831,4111
1,BRASILIA,DF,SAO PAULO,SP,38531.5,38531.5,77063,78041308,4112
2,RIO DE JANEIRO,RJ,BRASILIA,DF,45347,45347,90694,105005513,4112
3,SAO PAULO,SP,RIO DE JANEIRO,RJ,409739,409739,819478,357692694,4112
n,municipio1,uf1,municipio2,uf2,ida,volta,total,passxkm,sheet
1,BRASILIA,DF,BELEM,PA,5911,6113,12024,25320486,4114
2,BRASILIA,DF,BELO HORIZONTE,MG,53076,55794,108870,81392876,4114
3,BRASILIA,DF,CURITIBA,PR,5712,3428,9140,13231435,4114
4,BRASILIA,DF,FORTALEZA,CE,1698,1166,2864,7015533,4114
5,BRASILIA,DF,PORTO ALEGRE,RS,3695,4012,7707,17066822,4114
6,BRASILIA,DF,RECIFE,PE,4115,4262,8377,18821070,4114
7,BRASILIA,DF,SALVADOR,BA,15269,11993,27262,40521653,4114
8,RIO DE JANEIRO,RJ,BELEM,PA,6921,5995,12916,41754845,4114
9,RIO DE JANEIRO,RJ,BELO HORIZONTE,MG,200719,203805,404524,177464679,4114
10,RIO DE JANEIRO,RJ,CURITIBA,PR,43827,37113,80940,70814406,4114
11,RIO DE JANEIRO,RJ,FORTALEZA,CE,7982,7711,15693,43744437,4114
12,RIO DE JANEIRO,RJ,PORTO ALEGRE,RS,8327,8579,16906,27741654,4114
13,RIO DE JANEIRO,RJ,RECIFE,PE,11410,11914,23324,53820410,4114
14,RIO DE JANEIRO,RJ,SALVADOR,BA,28826,27674,56500,94376972,4114
15,SAO PAULO,SP,BELEM,PA,9544,9823,19367,57467699,4114
16,SAO PAULO,SP,BELO HORIZONTE,MG,252436,240277,492713,290897718,4114
17,SAO PAULO,SP,CURITIBA,PR,303890,298763,602653,264490845,4114
18,SAO PAULO,SP,FORTALEZA,CE,14259,18683,32942,101149114,4114
19,SAO PAULO,SP,PORTO ALEGRE,RS,32745,32745,65490,78478596,4114
20,SAO PAULO,SP,RECIFE,PE,28914,36160,65074,171485421,4114
21,SAO PAULO,SP,SALVADOR,BA,23612,20673,44285,86324926,4114
1,BRASILIA,DF,ANAPOLIS,GO,56885,62432,119317,19126515,4115
2,BRASILIA,DF,ARACAJU,SE,1832,2172,4004,6828822,4115
3,BRASILIA,DF,ARACATUBA,SP,1216,599,1815,1667545,4115
4,BRASILIA,DF,ARAGUARI,MG,6924,4796,11720,4652246,4115
5,BRASILIA,DF,BARBACENA,MG,1532,1632,3164,2833678,4115
6,BRASILIA,DF,CAMPINA GRANDE,PB,1961,2075,4036,10229781,4115
7,BRASILIA,DF,CAMPINAS,SP,1478,1407,2885,2699783,4115
8,BRASILIA,DF,CAMPO GRANDE,MS,6082,3989,10071,14646504,4115
9,BRASILIA,DF,CARUARU,PE,1605,1583,3188,7738551,4115
10,BRASILIA,DF,CASCAVEL,PR,1699,1752,3451,5480178,4115
11,BRASILIA,DF,CHAPECO,SC,158,179,337,629011,4115
12,BRASILIA,DF,CUIABA,MT,13080,12447,25527,29427716,4115
13,BRASILIA,DF,FLORIANOPOLIS,SC,4467,2430,6897,12141179,4115
14,BRASILIA,DF,FOZ DO IGUACU,PR,3530,3666,7196,12259373,4115
15,BRASILIA,DF,FRANCA,SP,3193,228,3421,2342359,4115
16,BRASILIA,DF,GOIANIA,GO,199562,167672,367234,76524340,4115
17,BRASILIA,DF,GOVERNADOR VALADARES,MG,467,406,873,967597,4115
18,BRASILIA,DF,JOAO PESSOA,PB,577,633,1210,3167417,4115
19,BRASILIA,DF,JUAZEIRO DO NORTE,CE,2,77,79,157471,4115
20,BRASILIA,DF,JUIZ DE FORA,MG,8419,8521,16940,16684206,4115
21,BRASILIA,DF,LONDRINA,PR,4639,4462,9101,10703851,4115
22,BRASILIA,DF,MACEIO,AL,1744,2188,3932,7758085,4115
23,BRASILIA,DF,MARINGA,PR,3582,3546,7128,9221028,4115
24,BRASILIA,DF,MOSSORO,RN,618,689,1307,3286713,4115
25,BRASILIA,DF,NATAL,RN,2723,3017,5740,15622142,4115
26,BRASILIA,DF,PALMAS,TO,1882,1794,3676,3533371,4115
27,BRASILIA,DF,PARNAIBA,PI,2620,3118,5738,11881677,4115
28,BRASILIA,DF,PASSO FUNDO,RS,93,128,221,399435,4115
29,BRASILIA,DF,PATOS DE MINAS,MG,29521,30744,60265,27182389,4115
30,BRASILIA,DF,PETROLINA,PE,1364,1210,2574,4650940,4115
31,BRASILIA,DF,PORTO VELHO,RO,1990,1782,3772,9898979,4115
32,BRASILIA,DF,POUSO ALEGRE,MG,1359,579,1938,1980055,4115
33,BRASILIA,DF,PRESIDENTE PRUDENTE,SP,2314,2184,4498,4695012,4115
34,BRASILIA,DF,RONDONOPOLIS,MT,2946,3180,6126,5750476,4115
35,BRASILIA,DF,SAO JOSE DO RIO PRETO,SP,8836,8651,17487,13466201,4115
36,BRASILIA,DF,SAO LUIS,MA,2375,2716,5091,11268929,4115
37,BRASILIA,DF,TEIXEIRA DE FREITAS,BA,1632,1484,3116,4560889,4115
38,BRASILIA,DF,TEOFILO OTONI,MG,399,323,722,859541,4115
39,BRASILIA,DF,TERESINA,PI,9688,9999,19687,36257249,4115
40,BRASILIA,DF,UBERABA,MG,12600,12586,25186,13428639,4115
41,BRASILIA,DF,UBERLANDIA,MG,18138,19208,37346,15921058,4115
42,BRASILIA,DF,VITORIA,ES,10089,9340,19429,24499969,4115
43,BRASILIA,DF,VITORIA DA CONQUISTA,BA,260,165,425,444168,4115
44,RIO DE JANEIRO,RJ,ANAPOLIS,GO,4813,5278,10091,13857375,4115
45,RIO DE JANEIRO,RJ,ARACAJU,SE,8249,7220,15469,29069939,4115
46,RIO DE JANEIRO,RJ,ARACATUBA,SP,5415,5565,10980,10871298,4115
47,RIO DE JANEIRO,RJ,ARAGUARI,MG,348,762,1110,1155510,4115
48,RIO DE JANEIRO,RJ,BARBACENA,MG,29590,27697,57287,15604979,4115
49,RIO DE JANEIRO,RJ,BARRETOS,SP,1133,1139,2272,1862131,4115
50,RIO DE JANEIRO,RJ,CACHOEIRO DO ITAPEMIRIM,ES,51989,54417,106406,42285712,4115
51,RIO DE JANEIRO,RJ,CAMPINA GRANDE,PB,21307,22481,43788,107868563,4115
52,RIO DE JANEIRO,RJ,CAMPINAS,SP,57505,56777,114282,57114422,4115
53,RIO DE JANEIRO,RJ,CAMPO GRANDE,MS,15504,15345,30849,45648680,4115
54,RIO DE JANEIRO,RJ,CARUARU,PE,2395,1169,3564,7990132,4115
55,RIO DE JANEIRO,RJ,CASCAVEL,PR,2196,3290,5486,7375231,4115
56,RIO DE JANEIRO,RJ,COLATINA,ES,4409,4269,8678,5543506,4115
57,RIO DE JANEIRO,RJ,CRATO,CE,2153,2763,4916,11051660,4115
58,RIO DE JANEIRO,RJ,CUIABA,MT,545,414,959,2012174,4115
59,RIO DE JANEIRO,RJ,FLORIANOPOLIS,SC,9056,8482,17538,20819360,4115
60,RIO DE JANEIRO,RJ,FOZ DO IGUACU,PR,10599,13566,24165,35930024,4115
61,RIO DE JANEIRO,RJ,FRANCA,SP,1883,2173,4056,3243583,4115
62,RIO DE JANEIRO,RJ,GARANHUNS,PE,2974,2312,5286,11689915,4115
63,RIO DE JANEIRO,RJ,GOIANIA,GO,12395,9256,21651,28650768,4115
64,RIO DE JANEIRO,RJ,GOVERNADOR VALADARES,MG,20878,17571,38449,22919449,4115
65,RIO DE JANEIRO,RJ,ITABUNA,BA,4714,3994,8708,10850429,4115
66,RIO DE JANEIRO,RJ,ITAJAI,SC,4107,4130,8237,9063873,4115
67,RIO DE JANEIRO,RJ,JOAO PESSOA,PB,8373,12213,20586,49770772,4115
68,RIO DE JANEIRO,RJ,JOINVILLE,SC,4474,4008,8482,8499574,4115
69,RIO DE JANEIRO,RJ,JUAZEIRO,BA,4,25,29,55222,4115
70,RIO DE JANEIRO,RJ,JUIZ DE FORA,MG,217799,236120,453919,87248865,4115
71,RIO DE JANEIRO,RJ,LONDRINA,PR,10023,10370,20393,19446765,4115
72,RIO DE JANEIRO,RJ,MACEIO,AL,5251,4705,9956,21737561,4115
73,RIO DE JANEIRO,RJ,MARINGA,PR,7954,7506,15460,16427062,4115
74,RIO DE JANEIRO,RJ,MOSSORO,RN,974,651,1625,4629788,4115
75,RIO DE JANEIRO,RJ,NATAL,RN,19739,18502,38241,98914171,4115
76,RIO DE JANEIRO,RJ,PALMAS,TO,1776,1597,3373,6908121,4115
77,RIO DE JANEIRO,RJ,PARNAIBA,PI,2908,3026,5934,17556926,4115
78,RIO DE JANEIRO,RJ,PASSO FUNDO,RS,1302,1284,2586,3669793,4115
79,RIO DE JANEIRO,RJ,PATOS DE MINAS,MG,2689,2212,4901,4052147,4115
80,RIO DE JANEIRO,RJ,PETROLINA,PE,1163,1624,2787,5364533,4115
81,RIO DE JANEIRO,RJ,PONTA GROSSA,PR,1630,1700,3330,3221109,4115
82,RIO DE JANEIRO,RJ,POUSO ALEGRE,MG,5526,4568,10094,3996215,4115
83,RIO DE JANEIRO,RJ,PRESIDENTE PRUDENTE,SP,3358,3425,6783,6885686,4115
84,RIO DE JANEIRO,RJ,RESENDE,RJ,136677,133732,270409,44076667,4115
85,RIO DE JANEIRO,RJ,RONDONOPOLIS,MT,252,108,360,678960,4115
86,RIO DE JANEIRO,RJ,SAO JOSE DO RIO PRETO,SP,12230,12162,24392,20401469,4115
87,RIO DE JANEIRO,RJ,SAO JOSE DOS CAMPOS,SP,30995,32933,63928,21837805,4115
88,RIO DE JANEIRO,RJ,SAO LUIS,MA,8241,6612,14853,45301650,4115
89,RIO DE JANEIRO,RJ,TEIXEIRA DE FREITAS,BA,9397,7782,17179,15146519,4115
90,RIO DE JANEIRO,RJ,TEOFILO OTONI,MG,8235,6931,15166,11008999,4115
91,RIO DE JANEIRO,RJ,TERESINA,PI,5603,5284,10887,28568577,4115
92,RIO DE JANEIRO,RJ,UBERABA,MG,5030,4737,9767,8739653,4115
93,RIO DE JANEIRO,RJ,UBERLANDIA,MG,9399,9509,18908,19036230,4115
94,RIO DE JANEIRO,RJ,VARGINHA,MG,8728,7140,15868,6279420,4115
95,RIO DE JANEIRO,RJ,VITORIA,ES,115608,115624,231232,118349411,4115
96,RIO DE JANEIRO,RJ,VITORIA DA CONQUISTA,BA,3640,2383,6023,6752637,4115
97,SAO PAULO,SP,ANAPOLIS,GO,5920,11548,17468,17120039,4115
98,SAO PAULO,SP,ARACAJU,SE,8774,8759,17533,37881471,4115
99,SAO PAULO,SP,ARACATUBA,SP,6873,7139,14012,7601510,4115
100,SAO PAULO,SP,ARAGUARI,MG,14891,11773,26664,16903133,4115
101,SAO PAULO,SP,BARBACENA,MG,10857,12974,23831,13107050,4115
102,SAO PAULO,SP,BARRA MANSA,RJ,21140,22340,43480,13686892,4115
103,SAO PAULO,SP,BLUMENAU,SC,34846,28419,63265,41320586,4115
104,SAO PAULO,SP,BRAGANCA PAULISTA,SP,8898,3529,12427,1096061,4115
105,SAO PAULO,SP,CABO FRIO,RJ,9551,9295,18846,10908065,4115
106,SAO PAULO,SP,CACHOEIRO DO ITAPEMIRIM,ES,5003,5163,10166,8285334,4115
107,SAO PAULO,SP,CAMPINA GRANDE,PB,15879,22251,38130,106662370,4115
108,SAO PAULO,SP,CAMPINAS,SP,161589,86804,248393,30105232,4115
109,SAO PAULO,SP,CAMPO GRANDE,MS,61872,62337,124209,129738470,4115
110,SAO PAULO,SP,CARUARU,PE,10566,22055,32621,83997040,4115
111,SAO PAULO,SP,CASCAVEL,PR,11145,9765,20910,19102229,4115
112,SAO PAULO,SP,CHAPECO,SC,7829,6480,14309,13480912,4115
113,SAO PAULO,SP,COLATINA,ES,3476,2183,5659,6027967,4115
114,SAO PAULO,SP,CRATO,CE,2239,1887,4126,10582777,4115
115,SAO PAULO,SP,CRICIUMA,SC,11976,8588,20564,19027150,4115
116,SAO PAULO,SP,CUIABA,MT,31579,31745,63324,106811864,4115
117,SAO PAULO,SP,FLORIANOPOLIS,SC,29105,36321,65426,48711091,4115
118,SAO PAULO,SP,FOZ DO IGUACU,PR,10749,9912,20661,21762103,4115
119,SAO PAULO,SP,GARANHUNS,PE,21290,18200,39490,102181066,4115
120,SAO PAULO,SP,GOIANIA,GO,60425,61492,121917,114808825,4115
121,SAO PAULO,SP,GOVERNADOR VALADARES,MG,21499,21370,42869,39486636,4115
122,SAO PAULO,SP,ITABUNA,BA,15009,14858,29867,49903525,4115
123,SAO PAULO,SP,ITAJAI,SC,9456,10251,19707,12930231,4115
124,SAO PAULO,SP,JOAO PESSOA,PB,4608,9935,14543,39940895,4115
125,SAO PAULO,SP,JOINVILLE,SC,44223,46655,90878,50659696,4115
126,SAO PAULO,SP,JUAZEIRO,BA,3944,3963,7907,17712109,4115
127,SAO PAULO,SP,JUAZEIRO DO NORTE,CE,17326,17177,34503,91346693,4115
128,SAO PAULO,SP,JUIZ DE FORA,MG,58556,55871,114427,58869268,4115
129,SAO PAULO,SP,LAGES,SC,7561,4023,11584,9135142,4115
130,SAO PAULO,SP,LONDRINA,PR,69004,67968,136972,72159598,4115
131,SAO PAULO,SP,MACEIO,AL,15899,16047,31946,77526736,4115
132,SAO PAULO,SP,MARINGA,PR,68282,69741,138023,87523684,4115
133,SAO PAULO,SP,MOGI-GUACU,SP,41531,46260,87791,15057903,4115
134,SAO PAULO,SP,MOSSORO,RN,6258,6003,12261,36162542,4115
135,SAO PAULO,SP,NATAL,RN,20990,17065,38055,110654532,4115
136,SAO PAULO,SP,NITEROI,RJ,210740,190254,400994,178362131,4115
137,SAO PAULO,SP,PALMAS,TO,4200,2497,6697,11942760,4115
138,SAO PAULO,SP,PARNAIBA,PI,9145,4217,13362,45231706,4115
139,SAO PAULO,SP,PASSO FUNDO,RS,12320,10612,22932,22333475,4115
140,SAO PAULO,SP,PATOS DE MINAS,MG,6363,6308,12671,10285531,4115
141,SAO PAULO,SP,PETROLINA,PE,5386,4418,9804,22218834,4115
142,SAO PAULO,SP,PONTA GROSSA,PR,40442,39488,79930,43136224,4115
143,SAO PAULO,SP,PORTO VELHO,RO,2629,2495,5124,16359433,4115
144,SAO PAULO,SP,POUSO ALEGRE,MG,101280,92394,193674,40342294,4115
145,SAO PAULO,SP,RESENDE,RJ,31562,31077,62639,17495313,4115
146,SAO PAULO,SP,RIO BRANCO,AC,542,349,891,3202432,4115
147,SAO PAULO,SP,RONDONOPOLIS,MT,9488,9445,18933,27994019,4115
148,SAO PAULO,SP,SAO JOSE DOS CAMPOS,SP,2831,1511,4342,399030,4115
149,SAO PAULO,SP,SAO LUIS,MA,5646,3598,9244,28633290,4115
150,SAO PAULO,SP,TEIXEIRA DE FREITAS,BA,13277,13224,26501,34659647,4115
151,SAO PAULO,SP,TEOFILO OTONI,MG,14379,22917,37296,39326759,4115
152,SAO PAULO,SP,TERESINA,PI,12324,12724,25048,75033862,4115
153,SAO PAULO,SP,UBERABA,MG,28607,27478,56085,27980806,4115
154,SAO PAULO,SP,UBERLANDIA,MG,40659,39194,79853,48662418,4115
155,SAO PAULO,SP,VARGINHA,MG,24394,21796,46190,14600659,4115
156,SAO PAULO,SP,VITORIA,ES,38566,35214,73780,69780364,4115
157,SAO PAULO,SP,VITORIA DA CONQUISTA,BA,52985,50404,103389,148929360,4115
158,SAO PAULO,SP,VOLTA REDONDA,RJ,42703,41404,84107,27098033,4115
1,PORTO ALEGRE,RS,FORTALEZA,CE,511,469,980,4191460,4117
2,CURITIBA,PR,PORTO ALEGRE,RS,33071,32424,65495,48804384,4117
3,CURITIBA,PR,FORTALEZA,CE,434,408,842,2956346,4117
4,BELO HORIZONTE,MG,CURITIBA,PR,24204,23126,47330,48835094,4117
5,BELO HORIZONTE,MG,SALVADOR,BA,7098,7919,15017,20430716,4117
6,BELO HORIZONTE,MG,RECIFE,PE,2505,2053,4558,9473067,4117
7,BELO HORIZONTE,MG,FORTALEZA,CE,1505,1360,2865,7094313,4117
8,BELO HORIZONTE,MG,BELEM,PA,2228,2615,4843,13627288,4117
9,SALVADOR,BA,BELEM,PA,2639,2376,5015,10222576,4117
10,RECIFE,PE,CURITIBA,PR,1961,2250,4211,13461891,4117
11,RECIFE,PE,SALVADOR,BA,18403,19198,37601,31305536,4117
12,FORTALEZA,CE,SALVADOR,BA,7265,8318,15583,20824117,4117
13,FORTALEZA,CE,RECIFE,PE,14635,14658,29293,23621875,4117
14,FORTALEZA,CE,BELEM,PA,17000,17970,34970,52934089,4117
15,BELEM,PA,RECIFE,PE,2137,2030,4167,8457343,4117
